11
0 0 0 S S 0 B 0 0 0 S
0 0 B 0 0 T 0 0 S S S
0 0 B 0 0 0 0 0 S B B
T T B 0 0 B B B S 0 T
B B 0 0 W 0 0 0 B 0 0
0 0 0 0 W 0 0 W W 0 0
0 T T 0 W T 0 0 T P 0
0 B 0 T T 0 B 0 T B T
0 B 0 0 W 0 B 0 B 0 B
0 S 0 0 W B B W W 0 B
0 B T T W 0 0 W W 0 B


